111111
1P0101
1000E1
1C1001
111111