111111
1000001
1P00E1
1000C1
111111